15 15 
 . . - - - - - - - . - - - - .
 - . - - - - - - - . - - - - .
 - . - - . . . . . . - - - - .
 - . - - - . - - - . . . . . .
 - . - - - . - - - . - - - - .
 - . . . . . - - - . - - - - .
 - - - . - - . - - . - - - - .
 - - - . - - . . . . . . . . .
 - - - . - - - . - - - - - - .
 . - - . - - - . - - - - - - .
 . . . . . . . . . . . - - - .
 . - - . - - - . - - . - - - .
 . - - . - - - . - - . . . - .
 . . . . - - - - - - - - . - .
 . - - - - - - - - - - - . . .